6 31 6 3 3 1
9 37 6 3 3 1
12 37 6 3 519 1
12 31 6 3 519 1
12 43 6 3 519 1
12 49 6 3 519 1
12 55 6 3 519 1
12 61 6 3 519 1
12 67 6 3 519 1
15 37 6 3 1 1
15 61 6 3 1 1
15 31 6 3 519 1
15 25 6 3 519 1
15 43 6 3 519 1
15 49 6 3 519 1
15 55 6 3 519 1
15 67 6 3 519 1
15 73 6 3 519 1
9 61 6 3 3 1
6 67 6 3 3 1
18 25 6 3 519 1
18 19 6 3 519 1
18 73 6 3 519 1
18 79 6 3 519 1
18 31 6 3 519 1
18 37 6 3 519 1
18 43 6 3 519 1
18 49 6 3 519 1
18 55 6 3 519 1
18 61 6 3 519 1
18 67 6 3 519 1
21 19 6 3 519 1
21 79 6 3 519 1
21 25 6 3 519 1
21 31 6 3 519 1
21 37 6 3 519 1
21 43 6 3 519 1
21 49 6 3 519 1
21 55 6 3 519 1
21 61 6 3 519 1
21 67 6 3 519 1
21 73 6 3 519 1
24 19 6 3 519 1
27 19 6 3 519 1
24 79 6 3 519 1
27 79 6 3 519 1
24 31 6 3 519 1
27 31 6 3 519 1
24 67 6 3 519 1
27 67 6 3 519 1
30 37 6 3 519 1
30 43 6 3 519 1
30 61 6 3 519 1
30 55 6 3 519 1
